5 4 3 2 4 
5 1 0 2 1 
4 4 5 2 5 
2 1 4 5 2 
5 2 2 0 1 
