6 0 2 1 1 6 
4 5 2 3 2 5 
4 5 4 4 5 6 
4 1 5 2 3 5 
3 5 1 5 3 2 
6 2 5 5 3 1 
