5 4 6 3 2 2 2 
5 5 5 4 3 3 1 
6 6 2 3 4 3 3 
0 1 4 4 3 1 4 
4 1 5 2 5 4 3 
5 6 4 6 1 6 0 
3 1 5 3 6 6 0 
